5 5
#####
# @ #
#   #
#   #
#####
