5 5
#####
#   #
#AA@#
#   #
#####
