5 5
#####
#@AB#
#   #
#   #
#####
