5 5
#####
#   #
#@A##
#   #
#####
