5 5
#####
#aAa#
#a1a#
#a@a#
#####
