5 5
#####
# @ #
#####
#   #
#####
