5 5
#####
#aAa#
#a@a#
#aAa#
#####
