4 6
######
#....#
#@A..#
#....#
######
