5 5
#####
#@Aa#
#   #
#   #
#####
