5 5
#####
#@# #
#   #
#   #
#####
